###############
#             #
############# #
############# #
#
###############